5 9
#########
#.......#
#.#####.#
#..E.S..#
#########